000000000000000
003000000000000
005000000460000
005000000660000
000000000000046
300000000000066
500000000000000
500000300000000
000000500000000
000000500000000
004600000000000
006600000000000
000000004600000
000000006600000
000000000000000
